[
    {
        "name":"Tutorial 1",
        "map":{
            "billboards":[
                [
                    {"position":[0,0],"texture":"assets/textures/billboards/tuto_move.png"},
                    {"position":[7,7],"texture":"assets/textures/billboards/tuto_flag.png"}
                ]
            ],
            "textures":[
                [
                    [0,0,0,0,0,3,3,3,3,3],
                    [0,0,0,0,0,3,2,2,2,3],
                    [0,0,0,0,0,3,2,2,2,3],
                    [3,3,3,3,3,3,2,2,2,3],
                    [3,2,2,2,2,2,2,2,2,3],
                    [3,2,2,2,2,2,2,2,2,3],
                    [3,3,3,3,3,3,3,3,3,3]
                ],[
                    [0,0,0,0,0,0,0,0,0,0],
                    [0,0,0,0,0,0,4,5,0,0],
                    [0,0,0,0,0,0,0,4,0,0],
                    [0,0,0,0,0,0,0,0,4,0],
                    [0,0,0,4,0,4,0,0,0,0],
                    [0,0,4,0,0,0,4,0,6,0],
                    [0,0,0,0,0,0,0,0,0,0]
                ]
            ],
            "elements":[
                [
                    [0,0,0,0,0,1,1,1,1,1],
                    [0,0,0,0,0,1,0,2,0,1],
                    [0,0,0,0,0,1,0,0,0,1],
                    [1,1,1,1,1,1,0,0,0,1],
                    [1,0,0,0,0,0,0,0,0,1],
                    [1,0,0,0,0,0,0,0,1,1],
                    [1,1,1,1,1,1,1,1,1,1]
                ]
            ],
            "spawn":{
                "position":[1,5],
                "keys":["m_n","m_e","m_s","m_w"]
            }
        }
    },{
        "name":"Tutorial 2",
        "map":{
            "billboards":[
                [
                    {"position":[-4,4],"texture":"assets/textures/billboards/tuto_quit.png"},
                    {"position":[2,-3],"texture":"assets/textures/billboards/tuto_oneflag.png"}
                ]
            ],
            "textures":[
                [
                    [2,2,2,2,2,2,2,2,2,2],
                    [2,2,2,2,2,2,2,2,2,2],
                    [2,2,2,2,2,2,2,2,2,2],
                    [2,2,2,2,2,2,2,2,2,2],
                    [2,2,2,2,2,2,2,2,2,2],
                    [2,2,2,2,2,2,2,2,2,2],
                    [2,2,2,2,2,2,2,2,2,2],
                    [2,2,2,2,2,2,2,2,2,2]
                ],[
                    [6,6,6,6,6,6,6,6,6,6],
                    [6,6,0,4,0,6,5,0,0,6],
                    [6,0,4,6,0,4,6,6,4,6],
                    [6,0,6,6,6,0,4,0,0,6],
                    [6,0,4,0,0,6,6,6,6,6],
                    [6,4,6,6,0,6,0,4,0,6],
                    [6,0,6,0,4,6,6,6,5,6],
                    [6,6,6,6,6,6,6,6,6,6]
                ]
            ],
            "elements":[
                [
                    [1,1,1,1,1,1,1,1,1,1],
                    [1,1,0,0,0,1,2,0,0,1],
                    [1,0,0,1,0,0,1,1,0,1],
                    [1,0,1,1,1,0,0,0,0,1],
                    [1,0,0,0,0,1,1,1,1,1],
                    [1,0,1,1,0,1,0,0,0,1],
                    [1,0,1,0,0,1,1,1,2,1],
                    [1,1,1,1,1,1,1,1,1,1]
                ]
            ],
            "spawn":{
                "position":[1,6],
                "keys":["m_n","m_e","m_s","m_w"]
            }
        }
    }
]